XXXXXXX XX XXXXXXXXX
XXXX XX XX      XXXX
XXXX XX XXXXXXXXXXXX
XX   XXXXXX   X   XX
XX XXXXXX   X X X XX
XX XXXXXX XXX   X XX
XX XXX    XXXXXXX XX
   XXXXXX XXXXXXX XX
XXXXXXXXX XXXXXXX  X
XXXXXXXXX  XXXXXXXXX
XXXXX         XXXXXX
XXXXX XXXXXXX XXX   
X   X XXX X X  XX XX
X XXX XXX X XX XXXXX
X XXX XXX X  X   XXX
X     XXX XX  XX XXX
X XX XXXX  XX  X X X
X XXXXXXXXX XX  XX X
X XX XXXXXX   X XX X
X XX XXXXXXXX X XX X
15
3
